Monster/&DH_Custom_AirTitan_Description	当被召唤时，这些远古元素表现为具有世界末日能力的生物，其存在就意味着毁灭。
Monster/&DH_Custom_AirTitan_Title	<color=#ff0000ff>原始空气泰坦</color>
Monster/&DH_Custom_AncientBlackDragon_Description	黑龙是五彩龙中最恶毒、最卑鄙的，它收集堕落人民的残骸和宝藏。这些龙厌恶看到弱者的繁荣并陶醉于类人王国的崩溃。他们在恶臭的沼泽和摇摇欲坠的废墟中安家，王国曾经矗立在那里。
Monster/&DH_Custom_AncientBlackDragon_Title	<color=#ff0000ff>远古黑龙</color>
Monster/&DH_Custom_AncientBlueDragon_Description	虚荣和领土，蓝龙在沙漠上空翱翔，捕食商队，掠夺沙漠无法触及的青翠土地上的畜群和定居点。这些龙也可以在干燥的草原、灼热的荒地和岩石海岸找到。他们守卫着自己的领地，对抗所有潜在的竞争者，尤其是黄铜龙。
Monster/&DH_Custom_AncientBlueDragon_Title	<color=#ff0000ff>远古蓝龙</color>
Monster/&DH_Custom_AncientGreenDragon_Description	绿龙是最狡猾和最奸诈的真龙，他们使用误导和诡计来在敌人面前占上风。脾气暴躁，邪恶至极，他们特别乐于颠覆和腐蚀善良的人。在它们漫游的古老森林中，绿龙表现出一种侵略性，这种侵略性通常与其说是为了领土，不如说是为了以尽可能少的努力获得权力和财富。
Monster/&DH_Custom_AncientGreenDragon_Title	<color=#ff0000ff>远古青龙</color>
Monster/&DH_Custom_AncientRedDragon_Description	最贪婪的真龙，红龙不知疲倦地寻求增加他们的宝藏。他们非常虚荣，即使对龙来说也是如此，他们的自负反映在他们骄傲的举止和对其他生物的蔑视中。
Monster/&DH_Custom_AncientRedDragon_Title	<color=#ff0000ff>远古红龙</color>
Monster/&DH_Custom_AncientWhiteDragon_Description	白龙是彩色龙中体型最小、最不聪明、最具兽性的一种，生活在寒冷的气候中，喜欢北极地区或冰冷的山脉。它们是由饥饿和贪婪驱使的恶毒、残忍的爬行动物。
Monster/&DH_Custom_AncientWhiteDragon_Title	<color=#ff0000ff>古白龙</color>
Monster/&DH_Custom_Archmage_Description	大法师是强大的（通常是相当古老的）施法者，致力于研究奥术。仁者谋君王后，恶者以暴君统治，追求巫妖。非善非恶的人将自己隔离在偏远的塔楼中，不间断地练习他们的魔法。
Monster/&DH_Custom_Archmage_Title	<color=#ff0000ff>大法师</color>
Monster/&DH_Custom_Balor_Description	古老而可怕的邪恶形象，巴洛人作为将军统治着恶魔军队，渴望在摧毁任何反对他们的生物的同时夺取权力
Monster/&DH_Custom_Balor_Title	<color=#ff0000ff>巴洛尔</color>
Monster/&DH_Custom_ConstructTitan_Description	为战争建造的大型建筑，由重金属制成。势不可挡的主宰，遵从创造者的命令而存在，按照创造者的要求进行保护或攻击。
Monster/&DH_Custom_ConstructTitan_Title	<color=#ff0000ff>机械构造泰坦</color>
Monster/&DH_Custom_Deva_Description	天神是作为主物质位面的神圣使者或代理人的天使，
Monster/&DH_Custom_Deva_Title	<color=#ff0000ff>天神</color>
Monster/&DH_Custom_Djinni_Description	来自空气元素位面的骄傲精灵，空气大师，djinn 骑着强大的旋风，他们一时兴起创造和指挥，甚至可以载客。
Monster/&DH_Custom_Djinni_Title	<color=#ff0000ff>神灵</color>
Monster/&DH_Custom_EarthTitan_Description	当被召唤时，这些远古元素表现为具有世界末日能力的生物，其存在就意味着毁灭。
Monster/&DH_Custom_EarthTitan_Title	<color=#ff0000ff>原始地球泰坦</color>
Monster/&DH_Custom_Efreeti_Description	火元素位面的巨大精灵，火巨灵是火焰大师，对火免疫并能够随心所欲地创造它。
Monster/&DH_Custom_Efreeti_Title	<color=#ff0000ff>以法莲</color>
Monster/&DH_Custom_Erinyes_Description	eryes 是凶猛而纪律严明的战士。从天而降，他们给那些冤枉主人的生物带来了迅速的死亡
Monster/&DH_Custom_Erinyes_Title	<color=#ff0000ff>埃里尼耶斯</color>
Monster/&DH_Custom_FireTitan_Description	当被召唤时，这些远古元素表现为具有世界末日能力的生物，其存在就意味着毁灭。
Monster/&DH_Custom_FireTitan_Title	<color=#ff0000ff>原始火泰坦</color>
Monster/&DH_Custom_GuardianNaga_Description	聪明善良，美丽的守护者龙族保护神圣的地方和神奇的力量物品不落入邪恶之手。在他们隐藏的堡垒中，他们研究咒语并制定错综复杂的阴谋来挫败敌人的邪恶计划。
Monster/&DH_Custom_GuardianNaga_Title	<color=#ff0000ff>守护纳迦</color>
Monster/&DH_Custom_HornedDevil_Description	地狱军团的飞行步兵，有角的恶魔听从命令。
Monster/&DH_Custom_HornedDevil_Title	<color=#ff0000ff>角魔</color>
Monster/&DH_Custom_IceDevil_Description	觊觎深渊恶魔上级的力量，冰魔不断地为晋升而努力，屠杀九层地狱的敌人，并为他们的大恶魔主人夺取尽可能多的灵魂。
Monster/&DH_Custom_IceDevil_Title	<color=#ff0000ff>冰魔</color>
Monster/&DH_Custom_Lich_Description	巫妖是伟大巫师的遗骸，他们接受不死生物作为保护自己的手段。他们不惜一切代价推进自己的权力，对生者的事务不感兴趣，除非这些事务干扰了他们自己的事务。诡计多端、精神错乱，他们渴望被遗忘已久的知识和最可怕的秘密。
Monster/&DH_Custom_Lich_Title	<color=#ff0000ff>巫妖</color>
Monster/&DH_Custom_Nalfeshnee_Description	nalfeshnee 是最怪诞的恶魔之一 - 猿和野猪的肥胖嘲弄，身高是人类的两倍，长着羽毛的翅膀对于它臃肿的身体来说似乎太小了。这些野蛮的特征隐藏着非凡的智慧和狡猾。
Monster/&DH_Custom_Nalfeshnee_Title	<color=#ff0000ff>纳尔菲什尼</color>
Monster/&DH_Custom_PitFiend_Description	大多数其他恶魔的无可争议的领主，深渊恶魔会参加九层地狱的大公和大公，并执行他们的愿望。这些强大的恶魔是九狱的将领，带领着九狱的地狱军团参战。
Monster/&DH_Custom_PitFiend_Title	<color=#ff0000ff>坑魔</color>
Monster/&DH_Custom_Planetar_Description	行星作为他们所侍奉的神祇的武器，展示了他们神祇力量的有形表现。
Monster/&DH_Custom_Planetar_Title	<color=#ff0000ff>行星</color>
Monster/&DH_Custom_Roc_Description	大鹏是可以存活数百年的孤独生物。它们的巢穴由树木、帐篷、破损的船只和它们带走的商队的残骸制成，将这些巨大的缠结放置在低等生物接触不到的山裂缝中。
Monster/&DH_Custom_Roc_Title	<color=#ff0000ff>大鹏</color>
Monster/&DH_Custom_Solar_Description	在战场上，太阳之剑会自己飞入战场，而太阳弓上的一箭可以击中一接触就死的目标。太阳的神力如此强大，以至于即使是恶魔王子也会在它的共振命令下收缩。
Monster/&DH_Custom_Solar_Title	<color=#ff0000ff>太阳能</color>
Monster/&DH_Custom_StormGiant_Description	风暴巨人是沉思的先知，生活在远离凡人文明的地方。大多数人都有淡紫灰色的皮肤和头发，还有闪闪发光的翡翠色眼睛。
Monster/&DH_Custom_StormGiant_Title	<color=#ff0000ff>风暴巨人</color>
Monster/&DH_Custom_Tarrasque_Description	传说中的泰拉斯克可能是主物质位面最可怕的怪物。人们普遍认为，这些生物中只有一种存在，尽管没有人能预测它会在何时何地袭击。一只有鳞的两足动物，恐猴高 50 英尺，长 70 英尺，重达数百吨
Monster/&DH_Custom_Tarrasque_Title	<color=#ff0000ff>魔龙</color>
Monster/&DH_Custom_Vampire_Description	在无尽的黑夜中醒来，吸血鬼渴望他们失去的生命，并通过喝活人的血来满足这种饥饿感。吸血鬼厌恶阳光，因为它的触碰会灼伤他们。他们从不投下阴影或倒影，任何想要在生者中被忽视的吸血鬼都会躲在黑暗中，远离反光表面。
Monster/&DH_Custom_Vampire_Title	<color=#ff0000ff>吸血鬼</color>
Monster/&DHCustomCouatlDescription	羽蛇是善良的蛇形生物，具有非凡的智慧和洞察力。它们色彩鲜艳的翅膀和温和的举止说明了它们的天国起源。
Monster/&DHCustomCouatlTitle	槲寄生
Monster/&OwlFamiliarDescription	猫头鹰熟悉
Monster/&OwlFamiliarTitle	猫头鹰
Monster/&WitchOwlFamiliarDescription	猫头鹰熟悉
Monster/&WitchOwlFamiliarTitle	猫头鹰
MonsterAttack/&DH_AirBlast_Attack_Description	5d6 打雷并推 2 格
MonsterAttack/&DH_AirBlast_Attack_Title	空气喷射
MonsterAttack/&DH_AirTitan_Slam_Attack_Descriptiond	4d6+6 钝击和 4d6 雷霆
MonsterAttack/&DH_AirTitan_Slam_Attack_Title	雷霆一击
MonsterAttack/&DH_AncientDragon_Tail_Attack_Description	2D8+8 钝击
MonsterAttack/&DH_AncientDragon_Tail_Attack_Title	尾部攻击
MonsterAttack/&DH_Balor_Longsword_Attack_Description	3D8+8 斩击 & 3D8 闪电
MonsterAttack/&DH_Balor_Longsword_Attack_Title	长剑攻击
MonsterAttack/&DH_Balor_Whip_Attack_Description	2D6+8 斩击和 3D6 火
MonsterAttack/&DH_Balor_Whip_Attack_Title	鞭子攻击
MonsterAttack/&DH_ConstructTitan_ForceCannon_Attack_Description	4D8 力量伤害和目标被击倒
MonsterAttack/&DH_ConstructTitan_ForceCannon_Attack_Title	力量大炮
MonsterAttack/&DH_ConstructTitan_Slam_Attack_Description	3D12+8 钝击伤害和目标被推 20 英尺
MonsterAttack/&DH_ConstructTitan_Slam_Attack_Title	大满贯
MonsterAttack/&DH_Custom_TarrasqueSwallowedcondition_Description	无法行动，每回合受到 16d6 酸液伤害。单次攻击造成60点伤害，可以迫使吞噬者反刍。
MonsterAttack/&DH_Custom_TarrasqueSwallowedcondition_Title	吞下
MonsterAttack/&DH_Custom_TarrasqueSwallowingcondition_Description	单次攻击造成60点伤害可以迫使它反刍。
MonsterAttack/&DH_Custom_TarrasqueSwallowingcondition_Title	吞咽生物
MonsterAttack/&DH_DamageAcid_Bite_Attack_Description	2D10+9 穿刺和 2D8 酸液伤害
MonsterAttack/&DH_DamageAcid_Bite_Attack_Title	酸咬攻击
MonsterAttack/&DH_DamageCold_Bite_Attack_Description	2D10+9 穿刺和 2D8 冰冷伤害
MonsterAttack/&DH_DamageCold_Bite_Attack_Title	冰噬攻击
MonsterAttack/&DH_DamageFire_Bite_Attack_Description	2D10+9 穿刺和 4D6 火焰伤害
MonsterAttack/&DH_DamageFire_Bite_Attack_Title	火咬攻击
MonsterAttack/&DH_DamageLightning_Bite_Attack_Description	2D10+9 穿刺和 2D10 闪电伤害
MonsterAttack/&DH_DamageLightning_Bite_Attack_Title	闪电之咬攻击
MonsterAttack/&DH_DamagePoison_Bite_Attack_Description	2D10+9 穿刺和 3D6 毒伤害
MonsterAttack/&DH_DamagePoison_Bite_Attack_Title	毒咬攻击
MonsterAttack/&DH_EarthTitan_Boulder_Attack_Description	7D10+8 钝击
MonsterAttack/&DH_EarthTitan_Boulder_Attack_Title	博尔德
MonsterAttack/&DH_EarthTitan_Slam_Attack_Description	4D10+8 钝击
MonsterAttack/&DH_EarthTitan_Slam_Attack_Title	大满贯
MonsterAttack/&DH_FireScimatar_Attack_Description	2d6+6 挥砍和 2d6 火
MonsterAttack/&DH_FireScimatar_Attack_Title	弯刀
MonsterAttack/&DH_FireTitan_Slam_Attack_Description	3d6+5 钝击 + 10d6 火
MonsterAttack/&DH_FireTitan_Slam_Attack_Title	灼热猛击
MonsterAttack/&DH_Fork_Attack_Description	2D8 +6 穿刺
MonsterAttack/&DH_Fork_Attack_Title	分叉攻击
MonsterAttack/&DH_Generic_Bite_Attack_No_ExtraDamage_Description	2d10 + 6 穿刺伤害
MonsterAttack/&DH_Generic_Bite_Attack_No_ExtraDamage_Title	咬攻击
MonsterAttack/&DH_Generic_Claw_Attack_Description	2D6 + 9 挥砍伤害
MonsterAttack/&DH_Generic_Claw_Attack_Title	爪击
MonsterAttack/&DH_Generic_Stronger_Bite_Attack_No_ExtraDamage_Description	2D10 + 9
MonsterAttack/&DH_Generic_Stronger_Bite_Attack_No_ExtraDamage_Title	咬攻击
MonsterAttack/&DH_HornedDevilTail_Attack_Description	1D8 +6 穿刺，造成流血伤
MonsterAttack/&DH_HornedDevilTail_Attack_Title	尾部攻击
MonsterAttack/&DH_HornedDevilTail_Attackcondition_Description	3D6 坏死，保存取消
MonsterAttack/&DH_HornedDevilTail_Attackcondition_Title	流血的伤口
MonsterAttack/&DH_HurlFlame_Attack_Description	5d6 火
MonsterAttack/&DH_HurlFlame_Attack_Title	投掷火焰
MonsterAttack/&DH_Ice_Bite_Attack_Description	2d6+5 穿刺 & 3d6 冰冷
MonsterAttack/&DH_Ice_Bite_Attack_Title	冰咬
MonsterAttack/&DH_Lich_ParalyzingTouch_Attack_Description	3D6 感冒并造成瘫痪状态
MonsterAttack/&DH_Lich_ParalyzingTouch_Attack_Title	麻痹之触
MonsterAttack/&DH_LightningScimatar_Attack_Description	2d6+5 挥砍和 2d6 闪电
MonsterAttack/&DH_LightningScimatar_Attack_Title	弯刀
MonsterAttack/&DH_NagaBite_Attack_Description	1d8+4 穿刺和 15 DC 体质豁免减半 10d8 毒
MonsterAttack/&DH_NagaBite_Attack_Title	毒咬
MonsterAttack/&DH_NagaSpit_Attack_Description	15 DC Con 豁免到一半 10d8 毒药
MonsterAttack/&DH_NagaSpit_Attack_Title	吐毒药
MonsterAttack/&DH_PitFiend_Bite_Attack_Description	2d6+7 中毒，造成中毒症状
MonsterAttack/&DH_PitFiend_Bite_Attack_Title	咬攻击
MonsterAttack/&DH_PitFiend_Bite_Attackcondition_Description	6D6 位置重复
MonsterAttack/&DH_PitFiend_Bite_Attackcondition_Title	中毒
MonsterAttack/&DH_PitFiend_Mace_Attack_Description	2D6+8 钝击和 6D6 火
MonsterAttack/&DH_PitFiend_Mace_Attack_Title	狼牙棒攻击
MonsterAttack/&DH_PoisonLongbow_Attack_Description	毒箭长弓
MonsterAttack/&DH_PoisonLongbow_Attack_Title	毒长弓
MonsterAttack/&DH_PoisonLongsword_Attack_Description	1d10+4 挥砍和 3d8 毒
MonsterAttack/&DH_PoisonLongsword_Attack_Title	毒长剑
MonsterAttack/&DH_RadiantLongbow_Attack_Description	2D6+8 穿刺 & 6D8 辐射
MonsterAttack/&DH_RadiantLongbow_Attack_Title	斩杀长弓。
MonsterAttack/&DH_RadiantLongsword_Attack_Description	4D6+8 斩击 & 6D8 光芒四射
MonsterAttack/&DH_RadiantLongsword_Attack_Title	光辉巨剑
MonsterAttack/&DH_Roc_Beak_Attack_Description	4d8+9 穿刺
MonsterAttack/&DH_Roc_Beak_Attack_Title	喙
MonsterAttack/&DH_Roc_Talons_Attack_Description	4d6+9 挥砍，目标被大鹏擒抱和束缚
MonsterAttack/&DH_Roc_Talons_Attack_Title	爪子
MonsterAttack/&DH_Tarrasque_Bite_Description	4d12 + 10 穿刺伤害并且目标必须通过敏捷检定或被擒抱（逃脱 DC 20）。
MonsterAttack/&DH_Tarrasque_Bite_Title	咬
MonsterAttack/&DH_Tarrasque_BiteCondition_Description	直到这次擒抱结束，目标被束缚。
MonsterAttack/&DH_Tarrasque_BiteCondition_Title	被魔龙抓住
MonsterAttack/&DH_Tarrasque_Claw_Description	4d8 + 10 挥砍伤害
MonsterAttack/&DH_Tarrasque_Claw_Title	爪
MonsterAttack/&DH_Tarrasque_Horn_Description	4d10 + 10) 穿刺伤害
MonsterAttack/&DH_Tarrasque_Horn_Title	喇叭
MonsterAttack/&DH_Tarrasque_Tail_Description	4d6 + 10 钝击伤害。如果目标是生物，它必须通过 DC 20 的力量豁免检定否则会被击倒
MonsterAttack/&DH_Tarrasque_Tail_Title	尾巴
MonsterAttack/&DHCouatlBiteAttackDescription	穿刺伤害，目标必须通过一次 DC 13 的体质豁免，否则会中毒 24 小时。在这种毒药结束之前，目标会失去知觉。
MonsterAttack/&DHCouatlBiteAttackTitle	咬
MonsterPower/&DH_AirTitan_Gale_Power_Description	4D10 雷霆并推动失败的保存
MonsterPower/&DH_AirTitan_Gale_Power_Title	呼啸狂风
MonsterPower/&DH_AirTitan_Lightning_Power_Description	3D10 区域闪电
MonsterPower/&DH_AirTitan_Lightning_Power_Title	雷击
MonsterPower/&DH_AncientDragon_Wing_Power_Description	龙可以扇动翅膀以产生足够的风来推动大多数类人生物并将它们击倒。
MonsterPower/&DH_AncientDragon_Wing_Power_Title	边路进攻
MonsterPower/&DH_Balor_FireAura_Power_Description	3D6 火
MonsterPower/&DH_Balor_FireAura_Power_Title	火光环
MonsterPower/&DH_BlindingGaze_Power_Description	DC15 体质豁免或被致盲，直到使用较小的恢复
MonsterPower/&DH_BlindingGaze_Power_Title	致盲凝视
MonsterPower/&DH_DamageAcid_Breath_Power_Description	15D8 酸
MonsterPower/&DH_DamageAcid_Breath_Power_Title	酸性呼吸
MonsterPower/&DH_DamageCold_Breath_Power_Description	16D8 寒冷
MonsterPower/&DH_DamageCold_Breath_Power_Title	冰呼吸
MonsterPower/&DH_DamageFire_Breath_Power_Description	26D6 火
MonsterPower/&DH_DamageFire_Breath_Power_Title	火焰吐息
MonsterPower/&DH_DamageLightning_Breath_Power_Description	16D10 闪电
MonsterPower/&DH_DamageLightning_Breath_Power_Title	闪电之息
MonsterPower/&DH_DamagePoison_Breath_Power_Description	22D6 毒药
MonsterPower/&DH_DamagePoison_Breath_Power_Title	毒气
MonsterPower/&DH_DisintegratingBeam_Power_Description	6D10 辐射伤害，目标在 0 HP 时解体
MonsterPower/&DH_DisintegratingBeam_Power_Title	分解光束
MonsterPower/&DH_EarthTitan_Earthquake_Power_Description	4D10 大刀阔斧
MonsterPower/&DH_EarthTitan_Earthquake_Power_Title	地震
MonsterPower/&DH_ErinyesParry_Power_Description	+3 交流
MonsterPower/&DH_ErinyesParry_Power_Title	招架
MonsterPower/&DH_FireTitan_Aura_Power_Description	其周围 30 英尺内的每个生物都会受到 35 (10d6) 点火焰伤害，并且没有穿戴或携带的光环中的易燃物体会被点燃。
MonsterPower/&DH_FireTitan_Aura_Power_Title	火泰坦光环
MonsterPower/&DH_FireTitan_Retaliate_DamageAffinity_Description	一个生物因接触 Maegera 或在其 10 英尺内用近战攻击击中它而受到 35 (10d6) 火焰伤害
MonsterPower/&DH_FireTitan_Retaliate_DamageAffinity_Title	火泰坦报复
MonsterPower/&DH_FireTitan_Retaliate_Power_Description	一个生物因接触 Maegera 或在其 10 英尺内用近战攻击击中它而受到 35 (10d6) 火焰伤害
MonsterPower/&DH_FireTitan_Retaliate_Power_Title	火泰坦报复
MonsterPower/&DH_IlluminatingCrystals_Power_Description	施法时该区域内的任何生物也会用光勾勒出轮廓。在此期间，物体和受影响的生物会在 10 英尺半径范围内散发出微弱的光芒。
MonsterPower/&DH_IlluminatingCrystals_Power_Title	发光水晶
MonsterPower/&DH_IncreasedGravityZone_Attack_Description	泰坦聚焦在其 20 英尺范围内的区域。任何在以该点为中心的半径为 20 英尺、高 20 英尺的圆柱体中的生物都必须成功通过 DC 26 的敏捷豁免，否则会受到 33 (6d10) 点钝击伤害并俯卧并被束缚一轮。
MonsterPower/&DH_IncreasedGravityZone_Attack_Title	增加重力区
MonsterPower/&DH_Lich_DisruptLife_Power_Description	6D6 坏死
MonsterPower/&DH_Lich_DisruptLife_Power_Title	扰乱生活
MonsterPower/&DH_SearingBurst_Power_Description	4D6 火 & 4D6 辐射
MonsterPower/&DH_SearingBurst_Power_Title	灼热爆发
MonsterPower/&DH_SummonCreature_Air_Elemental_Power_Description	召唤 1 个空气元素
MonsterPower/&DH_SummonCreature_Air_Elemental_Power_Title	召唤大元素
MonsterPower/&DH_SummonCreature_Earth_Elemental_Power_Description	召唤 1 个土元素
MonsterPower/&DH_SummonCreature_Earth_Elemental_Power_Title	召唤大元素
MonsterPower/&DH_SummonCreature_Erinyes_Power_Description	一个 Erinyes 被召唤去战斗
MonsterPower/&DH_SummonCreature_Erinyes_Power_Title	召唤奴才：击败
MonsterPower/&DH_SummonCreature_Fire_Elemental_Power_Description	召唤 1 个火元素
MonsterPower/&DH_SummonCreature_Fire_Elemental_Power_Title	召唤大元素
MonsterPower/&DH_SummonCreature_Fire_Jester_Power_Description	召唤 2 个火焰小丑
MonsterPower/&DH_SummonCreature_Fire_Jester_Power_Title	召唤次级元素
MonsterPower/&DH_SummonCreature_Nalfeshnee_Power_Description	Nalfeshnee 被召唤去战斗
MonsterPower/&DH_SummonCreature_Nalfeshnee_Power_Title	召唤奴才：纳尔菲什尼
MonsterPower/&DH_SummonCreature_SkarnGhoul_Power_Description	召唤 1 个斯卡恩食尸鬼
MonsterPower/&DH_SummonCreature_SkarnGhoul_Power_Title	召唤次级元素
MonsterPower/&DH_SummonCreature_WindSnake_Power_Description	召唤 4 条风蛇
MonsterPower/&DH_SummonCreature_WindSnake_Power_Title	召唤次级元素
MonsterPower/&DH_SummonCreature_Wolves_Power_Description	吸血鬼神奇地召唤 3d6 狼
MonsterPower/&DH_SummonCreature_Wolves_Power_Title	夜之子
MonsterPower/&DH_TarrasqueReflectiveCarapace_Immunity_Description	每当魔龙成为魔法飞弹法术、直线法术或需要远程攻击检定的法术的目标时，魔龙不受影响
MonsterPower/&DH_TarrasqueReflectiveCarapace_Immunity_Title	反光甲壳
MonsterPower/&DH_TarrasqueSwallowPower_Description	魔龙会对它正在擒抱的大型或小型生物进行一次啮咬攻击。如果攻击命中，目标被吞噬，擒抱结束。
MonsterPower/&DH_TarrasqueSwallowPower_Title	吞
MonsterPower/&DH_VampireCharmPower_Description	吸血鬼瞄准一个它可以在 30 英尺范围内看到的类人生物。目标必须成功通过一个 DC 17 的智慧豁免来对抗这种魔法，否则就会被吸血鬼魅惑。
MonsterPower/&DH_VampireCharmPower_Title	魅力
Spell/&DHTimeStop_SpellDescription	你短暂地停止了除了你自己以外的所有人的时间流动。其他生物没有时间流逝，而您连续进行1d4 + 1个回合，在此期间您可以正常使用动作和移动。
Spell/&DHTimeStop_SpellTitle	时间停止
Spell/&DHAnimalShapesSpellDescription	选择范围内你能看到的任意数量的自愿生物。你将每个目标转化为挑战等级为 4 或更低的大型或小型野兽。
Spell/&DHAnimalShapesSpellTitle	动物形状
MonsterPower/&DHAirTitanLightningStormPowerDescription	6d8 大范围闪电
MonsterPower/&DHAirTitanLightningStormPowerTitle	雷雨
MonsterPower/&DHGenericLightningAttackPowerDescription	12D8
MonsterPower/&DHGenericLightningAttackPowerTitle	雷击
Feature/&DH_AtWill_Fireball_Power_Description	随意火球
Feature/&DH_AtWill_Fireball_Power_Title	火球
Feature/&DH_AtWill_HoldMonster_Power_Description	每天 3 次使用
Feature/&DH_AtWill_HoldMonster_Power_Title	持有怪物
Feature/&DH_AtWill_Invisibility_Power_Description	随意隐身
Feature/&DH_AtWill_Invisibility_Power_Title	隐形
Condition/&DH_ReverseGravity_Spell_Description	反重力
Condition/&DH_ReverseGravity_Spell_Title	反重力
Condition/&DH_TimeStop_Spell_Description	被时间停止冻结
Condition/&DH_TimeStop_Spell_Title	被时间停止冻结
