ModUi/&AddHelpActionToAllRaces	Ajouter l'action <color=orange>Aide</color> à toutes les courses
ModUi/&DisableSenseDarkVisionFromAllRaces	Désactiver <color=orange>Sense Dark Vision</color> de toutes les races <b><i><color=red>[Nécessite un redémarrage]</color></i></b>
ModUi/&DisableSenseSuperiorDarkVisionFromAllRaces	Désactiver <color=orange>Superior Sense Dark Vision</color> de toutes les races <b><i><color=red>[Nécessite un redémarrage]</color></i></b>
ModUi/&EnableAlternateHuman	Activer l'humain alternatif <i><color=yellow>[+1 feat / +2 choix d'attributs / +1 skill]</color></i>
ModUi/&EnableFlexibleBackgrounds	Activer les arrière-plans flexibles <i><color=yellow>[sélectionner les compétences et les outils parmi les arrière-plans]</color></i>
ModUi/&EnableFlexibleRaces	Activer les races flexibles <i><color=yellow>[attribuer des points de capacité au lieu des valeurs raciales par défaut]</color></i>
ModUi/&EnableEpicPointsAndArray	Activez un système d'achat épique de 35 points et un tableau <i><color=yellow>[17,15,13,12,10,8]</color></i> <b><i><color=red>[ Nécessite un redémarrage]</color></i></b>
ModUi/&TotalFeatsGrantedFistLevel	<color=white>Total des dons accordés au premier niveau</color>
ModUi/&EnableMinInOutAttributes	Appliquer les scores de capacité minimum in & out pré-requis
ModUi/&EnableRelearnSpells	Peut sélectionner des tours mineurs ou des sorts déjà appris d'autres classes
ModUi/&DisplayAllKnownSpellsDuringLevelUp	Afficher tous les sorts connus des autres classes pendant la montée de niveau
ModUi/&MaxAllowedClasses	<color=white>Classes maximales autorisées</color> <b><i><color=red>[Nécessite un redémarrage]</color></i></b>
ModUi/&EnablesAsiAndFeat	Activer à la fois l'augmentation des scores d'attribut et la sélection des exploits <i><color=yellow>[au lieu d'un choix exclusif]</color></i>
ModUi/&EnableFeatsAtEvenLevels	Activer la sélection des exploits aux niveaux de classe 2, 6, 10 et 14
ModUi/&MaxAllowedLevels	<color=white>Niveaux maximum autorisés</color> <b><i><color=red>[Nécessite un redémarrage]</color></i></b>
ModUi/&AllowUnmarkedSorcerers	Autoriser les <color=orange>sorciers</color> non marqués
ModUi/&OfferAdditionalLoreFriendlyNames	Offrir des noms conviviaux supplémentaires lors de la création de personnage
ModUi/&UnlockAllNpcFaces	Déverrouiller tous les visages de PNJ
ModUi/&UnlockMarkAndTatoosForAllCharacters	Débloquez des marquages ​​et des tatouages ​​pour tous les personnages
ModUi/&UnlockEyeStyles	Déverrouiller les styles d'yeux
ModUi/&UnlockGlowingEyeColors	Débloquez des couleurs d'yeux éclatantes
ModUi/&UnlockGlowingColorsForAllMarksAndTatoos	Débloquez des couleurs éclatantes pour tous les marquages ​​et tatouages
ModUi/&UseOfficialAdvantageDisadvantageRules	Utiliser les règles officielles d'avantage/désavantage
ModUi/&AddBleedingToLesserRestoration	Ajoutez la condition <color=orange>Saignement</color> aux conditions supprimées par <color=orange>Grande et Petite Restauration</color>
ModUi/&BlindedConditionDontAllowAttackOfOpportunity	La condition <color=orange>Aveuglé</color> ne permet pas l'attaque d'opportunité
ModUi/&AllowTargetingSelectionWhenCastingChainLightningSpell	Autoriser la sélection de cible lors du lancement du sort <color=orange>Chaîne d'éclairs</color>
ModUi/&BestowCurseNoConcentrationRequiredForSlotLevel5OrAbove	<color=orange>Bestow Curse</color> ne nécessite pas de concentration lorsqu'il est lancé avec un emplacement de sort L5+
ModUi/&EnableUpcastConjureElementalAndFey	Activer l'upcast de <color=orange>Conjure Elemental</color>, <color=orange>Conjure Fey</color>
ModUi/&OnlyShowMostPowerfulUpcastConjuredElementalOrFey	<i>+ Afficher uniquement les créatures les plus puissantes dans la liste de conjuration</i>
ModUi/&FixSorcererTwinnedLogic	Correction de l'utilisation métamagique jumelle <color=orange>Sorcier</color> <i><color=yellow>[un sort doit être incapable de cibler plus d'une créature au niveau actuel du sort]</color></i>
ModUi/&FullyControlConjurations	Contrôlez entièrement les conjurations <i><color=yellow>[animaux, élémentaux, etc]</color></i>
ModUi/&AllowAnyClassToWearSylvanArmor	Autoriser n'importe quelle classe à porter une armure sylvestre
ModUi/&AllowDruidToWearMetalArmor	Autoriser le <color=orange>druide</color> à porter une armure en métal
ModUi/&DisableAutoEquip	Désactiver l'équipement automatique des objets dans l'inventaire
ModUi/&MakeAllMagicStaveArcaneFoci	Faire de tous les bâtons magiques des foyers arcaniques <i><color=yellow>[sauf le <color=orange>Bâton de guérison</color> qui est universel]</color></i> <b><i><color= rouge>[Nécessite un redémarrage]</color></i></b>
ModUi/&IncreaseSenseNormalVision	Augmentez la portée <color=orange>Sense Normal Vision</color> pour activer les attaques à longue portée <b><i><color=red>[Nécessite un redémarrage]</color></i></b>
ModUi/&QuickCastLightCantripOnWornItemsFirst	Le cantrip léger à lancer rapide utilise d'abord les objets portés sur la tête ou le torse
ModUi/&AddPickpocketableLoot	Ajouter un butin pickpocketable <i><color=yellow>[suggéré si la fonctionnalité <color=orange>Pickpocket</color> est activée]</color></i>
ModUi/&AllowStackedMaterialComponent	Autoriser le composant de matériau empilé <i><color=yellow>[par ex. 2 x 500 po de diamant équivaut à 1 000 po de diamant]</color></i>
ModUi/&ScaleMerchantPricesCorrectly	Mettre à l'échelle les prix marchands correctement/exactement
ModUi/&InitialChoices	<color=yellow>Choix initiaux :</color>
ModUi/&Multiclass	<color=yellow>Multiclasse :</color>
ModUi/&Progression	<color=yellow>Progression :</color>
ModUi/&Visuals	<color=yellow>Visuels :</color>
ModUi/&House	<color=yellow>Maison :</color>
ModUi/&SRD	<color=yellow>SRD :</color>
ModUi/&General	<color=yellow>Général :</color>
ModUi/&SelectAll	Tout sélectionner
ModUi/&SelectSuggested	Sélectionnez Suggéré
ModUi/&ExpandAll	Développer tout
ModUi/&ShowDescriptions	Afficher les descriptions
ModUi/&Races	<color=yellow>Courses</color>
ModUi/&Classes	<color=yellow>Cours</color>
ModUi/&Subclasses	<color=yellow>Sous-classes</color>
ModUi/&Feats	<color=yellow>Exploits</color>
ModUi/&FightingStyles	<color=yellow>Styles de combat</color>
ModUi/&SpellInstructions	. Vous pouvez attribuer individuellement chaque sort à n'importe quelle liste de sorts ou simplement sélectionner l'ensemble suggéré
ModUi/&SpellLevelFilter	<b><i><color=white>filtre de niveau de sorts</color> <color=yellow>[-1 pour afficher tous les sorts]</color></i></b>
ModUi/&EnableUnityExplorer	Activer l'interface utilisateur Unity Explorer
ModUi/&Patches	<color=yellow>Écussons :</color>
ModUi/&Basic	<color=yellow>Basique :</color>
ModUi/&Advanced	<color=yellow>Avancé :</color>
ModUI/&EnableBetaContent	Activer le contenu bêta <i><color=yellow>[gardez à l'esprit que vos sauvegardes ou vos héros pourraient tomber en panne à l'avenir]</color></i> <b><i><color=red>[Nécessite un redémarrage]</color></i></b>
ModUi/&Battle	<color=yellow>Bataille :</color>
ModUi/&DontFollowCharacterInBattle	La caméra de combat ne suit pas lorsque le personnage est déjà à l'écran
ModUi/&DontFollowMargin	<i>+ Sauf si le héros est éteint ou à moins de % du bord de l'écran</i>
ModUi/&AutoPauseOnVictory	Pause de l'interface utilisateur en cas de victoire au combat
ModUi/&FasterTimeModifier	<color=white>Modificateur de temps de jeu en appuyant sur la barre d'espace</color>
ModUi/&CampaignsAndLocations	<color=yellow>Campagnes et emplacements :</color>
ModUi/&FollowCharactersOnTeleport	La caméra suit le(s) personnage(s) téléporté(s)
ModUi/&EnableLogDialoguesToConsole	Activer les dialogues de journal sur la console de jeu pendant les séquences narratives
ModUi/&EnableAdditionalIconsOnLevelMap	Activer des icônes supplémentaires pour les camps, les sorties et les téléporteurs sur la carte de niveau
ModUi/&MarkInvisibleTeleportersOnLevelMap	<i>+ Marquer également l'emplacement des téléporteurs invisibles sur la carte de niveau après la découverte</i>
ModUi/&HideExitAndTeleporterGizmosIfNotDiscovered	Masquer les sorties et les effets visuels des téléporteurs s'ils ne sont pas encore découverts
ModUi/&InventoryAndItems	<color=yellow>Inventaire et articles :</color>
ModUi/&EnableInventoryFilteringAndSorting	Activer le filtrage et le tri de l'inventaire
ModUi/&EnableInventoryTaintNonProficientItemsRed	<i>+ Tache en rouge tout objet que le héros ne maîtrise pas</i>
ModUi/&EnableInvisibleCrownOfTheMagister	Masquez la <color=orange>couronne du magister</color> sur l'interface utilisateur du jeu
ModUi/&Monsters	<color=yellow>Monstres :</color>
ModUi/&HideMonsterHitPoints	Affiche la santé des monstres par paliers de 25 % / 50 % / 75 % / 100 % au lieu des points de vie exacts
ModUi/&RemoveBugVisualModels	Remplacez les modèles ressemblant à des bugs par des visuels alternatifs dans le jeu <b><i><color=red>[Nécessite un redémarrage]</color></i></b>
ModUi/&Spells	<color=yellow>Sorts :</color>
ModUi/&MaxSpellLevelsPerLine	<color=white>Niveaux max par ligne sur Spell Panel</color>
ModUi/&EmpressGarbAppearance	Apparence de <color=orange>habit d'impératrice</color>
ModUi/&EnableSaveByLocation	Activer l'enregistrement par campagnes/emplacements
ModUi/&EnableCharacterChecker	Activer l'écran de vérification des personnages
ModUi/&EnableCheatMenu	Activer le menu de triche
ModUi/&EnableRespec	Activer les actions RESPEC et Level Down après repos
ModUi/&Adventure	<color=yellow>Aventure :</color>
ModUi/&EnableTogglesToOverwriteDefaultTestParty	Activez les bascules sur le groupe de personnages pour définir votre partie de jeu et de test par défaut
ModUi/&NoExperienceOnLevelUp	Aucune expérience n'est requise pour monter de niveau
ModUi/&OverrideMinMaxLevel	Remplacer les niveaux minimum et maximum requis lors du démarrage de nouvelles aventures
ModUi/&MultiplyTheExperienceGainedBy	<color=white>Multipliez l'expérience acquise par</color> <color=red>[%]</color>
ModUi/&OverridePartySize	<color=white>Remplacer la taille du groupe dans les aventures personnalisées</color>
ModUi/&DungeonMaker	<color=yellow>Créateur de donjon :</color>
ModUi/&MaxBackupFilesPerLocationCampaign	<couleur=blanc>Max. fichiers de sauvegarde par lieu ou campagne</color>
ModUi/&MaxBackupHelp	. Les fichiers de sauvegarde sont enregistrés sous <i><color=yellow>GAME_FOLDER/Mods/SolastaCommunityExpansion/DungeonMakerBackups</color></i>
ModUi/&FactionRelations	<color=yellow>Relations entre factions :</color>
ModUi/&FactionHelp	<color=red>Charger un jeu de campagne officiel pour modifier les relations entre les factions...</color>
ModUi/&NotAvailable	Aucun {0} disponible sur ce mod pour le moment...
ModUi/&EnableShortRestRechargeOfArcaneWeaponOnWizardArcaneFighter	Activer la recharge de repos court de <color=orange>Arcane Weapon</color> sur <color=orange>Wizard</color> Arcane Fighter
ModUi/&EnableUnlimitedArcaneRecoveryOnWizardSpellMaster	Activez la <color=orange>récupération arcanique</color> illimitée sur <color=orange>Wizard</color> Spell Master\n<i><color=yellow>Doit être activé lorsque la capacité a des utilisations disponibles ou avant la création du personnage</color></i>
ModUi/&OverrideRogueConArtistImprovedManipulationSpellDc	<color=white>Remplacer <color=orange>Rogue</color> Con Artist <color=orange>Manipulation améliorée</color> Spell DC</color>
ModUi/&OverrideWizardMasterManipulatorArcaneManipulationSpellDc	<color=white>Remplacer <color=orange>Magicien</color> Maître Manipulateur <color=orange>Manipulation des Arcanes</color> Spell DC</color>
ModUi/&DungeonMakerBasicHelp	. Ces paramètres n'exigeront pas que le joueur ait installé ce mod
ModUi/&AllowDungeonsMaxLevel20	Autoriser les donjons avec un niveau maximum de 20 <b><i><color=red>[Nécessite un redémarrage]</color></i></b>
ModUi/&AllowGadgetsAndPropsToBePlacedAnywhere	Autoriser les gadgets et les accessoires à être placés n'importe où sur la carte <i><color=yellow>[appuyez sur <color=cyan>CTRL</color> pendant le placement pour ignorer toute vérification]</color></i>
ModUi/&UnleashNpcAsEnemy	Autoriser la sélection des PNJ sur les gadgets monstres <i><color=yellow>[appuyez sur <color=cyan>CTRL</color> tout en cliquant sur Sélectionner sur le panneau du gadget]</color></i>
ModUi/&UnleashEnemyAsNpc	Autoriser la sélection de monstres sur les gadgets des PNJ<i><color=yellow>[appuyez sur <color=cyan>CTRL</color> tout en cliquant sur Sélectionner sur le panneau des gadgets]</color></i>
ModUi/&AdvancedHelp	. <b><color=red>ATTENTION :</color></b> Ce paramètre nécessitera que le joueur ait installé ce mod
ModUi/&EnableDungeonMakerModdedContent	Activer Dungeon Maker Pro <b><i><color=red>[Nécessite un redémarrage]</color></i></b>\n\ncomprennent des pièces plates, des tailles de donjon de 150 x 150 et 200 x 200 et un mélange sans fioritures d'actifs de tous les environnements\nvous devez avoir au moins une pièce extérieure si vous choisissez un environnement extérieur
ModUi/&EnableExtraHighLevelMonsters	Activer des monstres supplémentaires de haut niveau (+20 CR) pour les campagnes de niveau 3 et 4 <b><i><color=red>[Nécessite un redémarrage]</color></i></b>
ModUi/&EnableCancelEditOnRightMouseClick	Activer l'action d'annulation avec un clic droit de la souris
ModUi/&EnableHotkeyToggleIndividualHud	Activer <color=cyan>CTRL-SHIFT-(C</color>)panneau de contrôle, <color=cyan>CTRL-SHIFT-(L</color>)og, <color=cyan>CTRL-SHIFT-(M< /color>)ap et <color=cyan>CTRL-SHIFT-(P</color>)arty pour basculer la visibilité de chaque panneau de l'interface utilisateur
ModUi/&EnableHotkeyToggleHud	Activez <color=cyan>CTRL-SHIFT-(H</color>)ud pour basculer la visibilité de tous les panneaux de l'interface utilisateur
ModUi/&EnableCharacterExport	Activer <color=cyan>CTRL-SHIFT-(E</color>)xporter le caractère <i><color=yellow>[sur l'écran d'inspection des caractères uniquement]</color></i>
ModUi/&EnableHotkeyDebugOverlay	Activer la superposition d'ebug <color=cyan>CTRL-SHIFT-(D</color>)
ModUi/&EnableHotkeyZoomCamera	Activer la caméra <color=cyan>CTRL-SHIFT-(Z</color>)oom <i><color=yellow>[utile lors de la prise de captures d'écran de donjon pour la publication]</color></i>
ModUi/&EnableTeleportParty	Activer <color=cyan>CTRL-SHIFT-(T</color>)eleport party <i><color=yellow>[vous pourriez casser des quêtes ou des cartes si vous vous téléportez vers un lieu inconnu]</color></i>
ModUi/&AltOnlyHighlightItemsInPartyFieldOfView	La touche <color=cyan>ALT</color> ne met en évidence que les gadgets dans le champ de vision du groupe [uniquement dans les donjons personnalisés]
ModUi/&InvertAltBehaviorOnTooltips	Inverser le comportement de la touche <color=cyan>ALT</color> dans les infobulles
ModUi/&EnableCtrlClickBypassMetamagicPanel	Activez le <color=cyan>CTRL</color> clic sur les sorts pour ignorer le panneau métamagique <color=orange>Sorcier</color>
ModUi/&EnableCtrlClickBypassAttackReactionPanel	Activez <color=cyan>CTRL</color> cliquez sur les attaques pour ignorer tout panneau de réaction
ModUi/&EnableIgnoreCtrlClickOnCriticalHit	<i>+ contournement uniquement si pas un coup critique</i>
ModUi/&EnableCtrlClickOnlySwapsMainHand	Activez le clic <color=cyan>CTRL</color> pour ne pas toucher aux objets lorsque vous changez de configuration.
ModUi/&MulticlassKeyHelp	Un clic <color=cyan>SHIFT</color> sur un sort consomme un emplacement de sort au lieu de celui par défaut de la magie du pacte