ModUi/&AddHelpActionToAllRaces	Füge allen Rennen die Aktion <color=orange>Hilfe</color> hinzu
ModUi/&DisableSenseDarkVisionFromAllRaces	Deaktiviere <color=orange>Dunkle Sicht wahrnehmen</color> für alle Rassen <b><i><color=red>[Neustart erforderlich]</color></i></b>
ModUi/&DisableSenseSuperiorDarkVisionFromAllRaces	Deaktiviere <color=orange>Superior Sense Dark Vision</color> für alle Rassen <b><i><color=red>[Neustart erforderlich]</color></i></b>
ModUi/&EnableAlternateHuman	Aktiviere den alternativen Menschen <i><color=yellow>[+1 Talent / +2 Attributauswahl / +1 Fertigkeit]</color></i>
ModUi/&EnableFlexibleBackgrounds	Aktivieren Sie flexible Hintergründe <i><color=yellow>[wählen Sie Fertigkeits- und Werkzeugkenntnisse aus Hintergründen aus]</color></i>
ModUi/&EnableFlexibleRaces	Flexible Rassen aktivieren <i><color=yellow>[Fähigkeitspunktzahl statt der Rassenvorgaben zuweisen]</color></i>
ModUi/&EnableEpicPointsAndArray	Aktivieren Sie ein episches 35-Punkte-Kaufsystem und Array <i><color=yellow>[17,15,13,12,10,8]</color></i> <b><i><color=red>[ Neustart erforderlich]</color></i></b>
ModUi/&TotalFeatsGrantedFistLevel	<color=white>Auf der ersten Stufe gewährte Talente insgesamt</color>
ModUi/&EnableMinInOutAttributes	Erzwingen Sie die minimalen Ein- und Ausstiegsvoraussetzungen für Fähigkeitswerte
ModUi/&EnableRelearnSpells	Kann Cantrips oder Zaubersprüche auswählen, die bereits von anderen Klassen erlernt wurden
ModUi/&DisplayAllKnownSpellsDuringLevelUp	Zeigen Sie während des Levelaufstiegs alle bekannten Zaubersprüche aus anderen Klassen an
ModUi/&MaxAllowedClasses	<color=white>Max. zulässige Klassen</color> <b><i><color=red>[Neustart erforderlich]</color></i></b>
ModUi/&EnablesAsiAndFeat	Aktivieren Sie sowohl die Erhöhung der Attributwerte als auch die Talentauswahl <i><color=yellow>[statt einer exklusiven Auswahl]</color></i>
ModUi/&EnableFeatsAtEvenLevels	Aktivieren Sie die Talentauswahl auf den Klassenstufen 2, 6, 10 und 14
ModUi/&MaxAllowedLevels	<color=white>Max. zulässige Stufen</color> <b><i><color=red>[Neustart erforderlich]</color></i></b>
ModUi/&AllowUnmarkedSorcerers	Erlaube unmarkierte <color=orange>Zauberer</color>
ModUi/&OfferAdditionalLoreFriendlyNames	Bieten Sie zusätzliche Lore-freundliche Namen bei der Charaktererstellung an
ModUi/&UnlockAllNpcFaces	Schalte alle NPC-Gesichter frei
ModUi/&UnlockMarkAndTatoosForAllCharacters	Schalte Markierungen und Tattoos für alle Charaktere frei
ModUi/&UnlockEyeStyles	Schalte Augenstile frei
ModUi/&UnlockGlowingEyeColors	Schalte leuchtende Augenfarben frei
ModUi/&UnlockGlowingColorsForAllMarksAndTatoos	Schalten Sie leuchtende Farben für alle Markierungen und Tätowierungen frei
ModUi/&UseOfficialAdvantageDisadvantageRules	Verwenden Sie die offiziellen Vorteils- / Nachteilsregeln
ModUi/&AddBleedingToLesserRestoration	Fügen Sie den Zustand <color=orange>Bluten</color> zu den Zuständen hinzu, die durch <color=orange>Größere und Geringere Wiederherstellung</color> entfernt wurden
ModUi/&BlindedConditionDontAllowAttackOfOpportunity	Der Zustand <color=orange>Geblendet</color> erlaubt keinen Gelegenheitsangriff
ModUi/&AllowTargetingSelectionWhenCastingChainLightningSpell	Zielauswahl beim Wirken des Zaubers <color=orange>Kettenblitz</color> zulassen
ModUi/&BestowCurseNoConcentrationRequiredForSlotLevel5OrAbove	<color=orange>Fluch verleihen</color> erfordert keine Konzentration, wenn es mit einem L5+-Zauberplatz gewirkt wird
ModUi/&EnableUpcastConjureElementalAndFey	Upcast von <color=orange>Elementar beschwören</color>, <color=orange>Feen beschwören</color> aktivieren
ModUi/&OnlyShowMostPowerfulUpcastConjuredElementalOrFey	<i>+ Nur die mächtigsten Kreaturen in der Beschwörungsliste anzeigen</i>
ModUi/&FixSorcererTwinnedLogic	Repariere <color=orange>Zauberer</color>-Zwillings-Metamagie-Gebrauch <i><color=yellow>[ein Zauber darf nicht in der Lage sein, auf mehr als eine Kreatur auf der aktuellen Stufe des Zaubers zu zielen]</color></i>
ModUi/&FullyControlConjurations	Volle Kontrolle über Beschwörungen <i><color=yellow>[Tiere, Elementare usw.]</color></i>
ModUi/&AllowAnyClassToWearSylvanArmor	Erlaube jeder Klasse, Waldrüstungen zu tragen
ModUi/&AllowDruidToWearMetalArmor	Erlaube dem <color=orange>Druiden</color>, Metallrüstungen zu tragen
ModUi/&DisableAutoEquip	Deaktiviere das automatische Ausrüsten von Gegenständen im Inventar
ModUi/&MakeAllMagicStaveArcaneFoci	Mache alle magischen Stäbe zu arkanen Brennpunkten <i><color=yellow>[außer <color=orange>Stab der Heilung</color>, der universell ist]</color></i> <b><i><color= red>[Neustart erforderlich]</color></i></b>
ModUi/&IncreaseSenseNormalVision	Erhöhen Sie die Reichweite von <color=orange>Normale Sicht wahrnehmen</color>, um Langstreckenangriffe zu ermöglichen <b><i><color=red>[Neustart erforderlich]</color></i></b>
ModUi/&QuickCastLightCantripOnWornItemsFirst	Quick Cast Light Cantrip verwendet zuerst am Kopf oder Oberkörper getragene Gegenstände
ModUi/&AddPickpocketableLoot	Taschendiebstahl-Beute hinzufügen <i><color=yellow>[empfohlen, wenn <color=orange>Taschendiebstahl</color>-Talent aktiviert ist]</color></i>
ModUi/&AllowStackedMaterialComponent	Gestapelte Materialkomponente zulassen <i><color=yellow>[z.B. 2x500gp Diamant entspricht 1000gp Diamant]</color></i>
ModUi/&ScaleMerchantPricesCorrectly	Händlerpreise richtig / exakt skalieren
ModUi/&InitialChoices	<color=yellow>Anfangsauswahl:</color>
ModUi/&Multiclass	<color=yellow>Mehrfachklasse:</color>
ModUi/&Progression	<color=yellow>Fortschritt:</color>
ModUi/&Visuals	<color=yellow>Visuals:</color>
ModUi/&House	<color=yellow>Haus:</color>
ModUi/&SRD	<color=yellow>SRD:</color>
ModUi/&General	<color=yellow>Allgemein:</color>
ModUi/&SelectAll	Wählen Sie Alle
ModUi/&SelectSuggested	Wählen Sie Vorgeschlagen aus
ModUi/&ExpandAll	Alle erweitern
ModUi/&ShowDescriptions	Beschreibungen anzeigen
ModUi/&Races	<color=yellow>Rennen</color>
ModUi/&Classes	<color=yellow>Klassen</color>
ModUi/&Subclasses	<color=yellow>Unterklassen</color>
ModUi/&Feats	<color=yellow>Leistungen</color>
ModUi/&FightingStyles	<color=yellow>Kampfstile</color>
ModUi/&SpellInstructions	. Du kannst jeden Zauber einzeln jeder Zauberliste zuordnen oder einfach das vorgeschlagene Set auswählen
ModUi/&SpellLevelFilter	<b><i><color=white>Zauberstufenfilter</color> <color=yellow>[-1, um alle Zauber anzuzeigen]</color></i></b>
ModUi/&EnableUnityExplorer	Aktivieren Sie die Unity Explorer-Benutzeroberfläche
ModUi/&Patches	<color=yellow>Aufnäher:</color>
ModUi/&Basic	<color=yellow>Einfach:</color>
ModUi/&Advanced	<color=yellow>Erweitert:</color>
ModUI/&EnableBetaContent	Beta-Inhalte aktivieren <i><color=yellow>[denke daran, dass deine Spielstände oder Helden in Zukunft kaputt gehen könnten]</color></i> <b><i><color=red>[Neustart erforderlich]</color></i></b>
ModUi/&Battle	<color=yellow>Kampf:</color>
ModUi/&DontFollowCharacterInBattle	Die Kampfkamera folgt nicht, wenn der Charakter bereits auf dem Bildschirm ist
ModUi/&DontFollowMargin	<i>+ Es sei denn, der Held ist ausgeschaltet oder innerhalb von % des Bildschirmrands</i>
ModUi/&AutoPauseOnVictory	Pausiere die Benutzeroberfläche, wenn du im Kampf siegst
ModUi/&FasterTimeModifier	<color=white>Spielzeitmodifikator beim Drücken der Leertaste</color>
ModUi/&CampaignsAndLocations	<color=yellow>Kampagnen und Standorte:</color>
ModUi/&FollowCharactersOnTeleport	Kamera folgt teleportierten Charakteren
ModUi/&EnableLogDialoguesToConsole	Aktivieren Sie Protokolldialoge zur Spielkonsole während narrativer Sequenzen
ModUi/&EnableAdditionalIconsOnLevelMap	Aktivieren Sie zusätzliche Symbole für Lager, Ausgänge und Teleporter auf der Levelkarte
ModUi/&MarkInvisibleTeleportersOnLevelMap	<i>+ Markieren Sie nach der Entdeckung auch die Position unsichtbarer Teleporter auf der Levelkarte</i>
ModUi/&HideExitAndTeleporterGizmosIfNotDiscovered	Blenden Sie die visuellen Effekte von Ausgängen und Teleportern aus, wenn sie noch nicht entdeckt wurden
ModUi/&InventoryAndItems	<color=yellow>Inventar und Gegenstände:</color>
ModUi/&EnableInventoryFilteringAndSorting	Inventarfilterung und -sortierung aktivieren
ModUi/&EnableInventoryTaintNonProficientItemsRed	<i>+ Beflecke alle Gegenstände, mit denen der Held nicht vertraut ist, rot</i>
ModUi/&EnableInvisibleCrownOfTheMagister	Blende die <color=orange>Krone des Magisters</color> auf der Spieloberfläche aus
ModUi/&Monsters	<color=yellow>Monster:</color>
ModUi/&HideMonsterHitPoints	Zeigt die Gesundheit von Monstern in Schritten von 25 % / 50 % / 75 % / 100 % anstelle der genauen Trefferpunkte an
ModUi/&RemoveBugVisualModels	Ersetzen Sie fehlerähnliche Modelle durch alternative visuelle Elemente im Spiel <b><i><color=red>[Neustart erforderlich]</color></i></b>
ModUi/&Spells	<color=yellow>Zauber:</color>
ModUi/&MaxSpellLevelsPerLine	<color=white>Maximale Stufen pro Zeile im Zauberfeld</color>
ModUi/&EmpressGarbAppearance	Aussehen <color=orange>Kaiserin-Gewand</color>
ModUi/&EnableSaveByLocation	Speichern nach Kampagnen/Standorten aktivieren
ModUi/&EnableCharacterChecker	Aktivieren Sie den Zeichenprüfbildschirm
ModUi/&EnableCheatMenu	Aktivieren Sie das Cheat-Menü
ModUi/&EnableRespec	Aktivieren Sie die Aktionen RESPEC und Level Down nach Ruhe
ModUi/&Adventure	<color=yellow>Abenteuer:</color>
ModUi/&EnableTogglesToOverwriteDefaultTestParty	Aktivieren Sie Umschalter im Charakterpool, um Ihre Standardspiel- und Testgruppe festzulegen
ModUi/&NoExperienceOnLevelUp	Für den Levelaufstieg ist keine Erfahrung erforderlich
ModUi/&OverrideMinMaxLevel	Überschreiben Sie die erforderlichen Mindest- und Höchststufen, wenn Sie neue Abenteuer beginnen
ModUi/&MultiplyTheExperienceGainedBy	<color=white>Multipliziere die gewonnene Erfahrung mit</color> <color=red>[%]</color>
ModUi/&OverridePartySize	<color=white>Gruppengröße in benutzerdefinierten Abenteuern überschreiben</color>
ModUi/&DungeonMaker	<color=yellow>Dungeon Maker:</color>
ModUi/&MaxBackupFilesPerLocationCampaign	<color=white>max. Sicherungsdateien pro Standort oder Kampagne</color>
ModUi/&MaxBackupHelp	. Sicherungsdateien werden unter <i><color=yellow>GAME_FOLDER/Mods/SolastaCommunityExpansion/DungeonMakerBackups</color></i> gespeichert
ModUi/&FactionRelations	<color=yellow>Fraktionsbeziehungen:</color>
ModUi/&FactionHelp	<color=red>Lade ein offizielles Kampagnenspiel, um die Fraktionsbeziehungen zu ändern...</color>
ModUi/&NotAvailable	Für diesen Mod ist noch kein {0} verfügbar ...
ModUi/&EnableShortRestRechargeOfArcaneWeaponOnWizardArcaneFighter	Aktiviere die kurze Erholungsaufladung der <color=orange>Arkanen Waffe</color> auf dem <color=orange>Magier</color>-Arkankämpfer
ModUi/&EnableUnlimitedArcaneRecoveryOnWizardSpellMaster	Aktiviere unbegrenzte <color=orange>Arkane Wiederherstellung</color> auf <color=orange>Magier</color>-Zaubermeister\n<i><color=yellow>Muss aktiviert werden, wenn die Fähigkeit nutzbar ist oder vor der Charaktererstellung</color></i>
ModUi/&OverrideRogueConArtistImprovedManipulationSpellDc	<color=white>Überschreibe <color=orange>Schurke</color> Betrüger <color=orange>Verbesserte Manipulation</color> Zauber-SG</color>
ModUi/&OverrideWizardMasterManipulatorArcaneManipulationSpellDc	<color=white>Überschreibe <color=orange>Wizard</color>-Meistermanipulator <color=orange>Arkane Manipulation</color>-Zauber-SG</color>
ModUi/&DungeonMakerBasicHelp	. Diese Einstellungen erfordern nicht, dass der Spieler diesen Mod installiert hat
ModUi/&AllowDungeonsMaxLevel20	Erlaube Dungeons mit maximaler Stufe 20 <b><i><color=red>[Neustart erforderlich]</color></i></b>
ModUi/&AllowGadgetsAndPropsToBePlacedAnywhere	Ermöglicht das Platzieren von Gadgets und Requisiten überall auf der Karte <i><color=yellow>[drücken Sie während der Platzierung <color=cyan>STRG</color>, um jede Überprüfung zu umgehen]</color></i>
ModUi/&UnleashNpcAsEnemy	Erlaube die Auswahl von NPCs auf Monster-Gadgets <i><color=yellow>[drücke <color=cyan>STRG</color>, während du im Gadget-Feld auf „Auswählen“ klickst]</color></i>
ModUi/&UnleashEnemyAsNpc	Erlaube die Auswahl von Monstern auf NPC-Gadgets<i><color=yellow>[drücke <color=cyan>STRG</color>, während du im Gadget-Feld auf „Auswählen“ klickst]</color></i>
ModUi/&AdvancedHelp	. <b><color=red>ACHTUNG:</color></b> Diese Einstellung erfordert, dass der Spieler diesen Mod installiert hat
ModUi/&EnableDungeonMakerModdedContent	Aktivieren Sie Dungeon Maker Pro <b><i><color=red>[Neustart erforderlich]</color></i></b>\n\nDazu gehören flache Räume, Dungeongrößen von 150 x 150 und 200 x 200 und schnörkellose Mischung von Assets aus allen Umgebungen\nSie müssen mindestens einen Raum im Freien haben, wenn Sie sich für eine Umgebung im Freien entscheiden
ModUi/&EnableExtraHighLevelMonsters	Aktiviere zusätzliche hochstufige Monster (+20 CR) für Kampagnen der Stufen 3 und 4 <b><i><color=red>[Neustart erforderlich]</color></i></b>
ModUi/&EnableCancelEditOnRightMouseClick	Aktivieren Sie die Abbruchaktion mit einem Rechtsklick
ModUi/&EnableHotkeyToggleIndividualHud	Aktivieren Sie <color=cyan>CTRL-SHIFT-(C</color>)Systemsteuerung, <color=cyan>CTRL-SHIFT-(L</color>)og, <color=cyan>CTRL-SHIFT-(M</color>)ap und <color=cyan>CTRL-SHIFT-(P</color>)arty, um die Sichtbarkeit der einzelnen UI-Panels umzuschalten
ModUi/&EnableHotkeyToggleHud	Aktivieren Sie <color=cyan>CTRL-SHIFT-(H</color>)ud, um die Sichtbarkeit aller UI-Panels umzuschalten
ModUi/&EnableCharacterExport	Aktivieren Sie <color=cyan>CTRL-SHIFT-(E</color>)xport-Zeichen <i><color=yellow>[nur auf dem Zeichenprüfbildschirm]</color></i>
ModUi/&EnableHotkeyDebugOverlay	Aktivieren Sie <color=cyan>CTRL-SHIFT-(D</color>)ebug-Overlay
ModUi/&EnableHotkeyZoomCamera	Aktivieren Sie <color=cyan>STRG-UMSCHALT-(Z</color>)Raumkamera <i><color=yellow>[nützlich beim Aufnehmen von Dungeon-Screenshots zum Veröffentlichen]</color></i>
ModUi/&EnableTeleportParty	Aktivieren Sie <color=cyan>CTRL-SHIFT-(T</color>)eleport party <i><color=yellow>[Sie könnten Quests oder Karten brechen, wenn Sie sich an einen unentdeckten Ort teleportieren]</color></i>
ModUi/&AltOnlyHighlightItemsInPartyFieldOfView	<color=cyan>ALT</color>-Taste markiert nur Gadgets im Sichtfeld der Gruppe [nur in benutzerdefinierten Dungeons]
ModUi/&InvertAltBehaviorOnTooltips	Kehrt das Verhalten der <color=cyan>ALT</color>-Taste in Tooltips um
ModUi/&EnableCtrlClickBypassMetamagicPanel	Aktivieren Sie <color=cyan>STRG</color>, klicken Sie auf Zaubersprüche, um das metamagische Bedienfeld <color=orange>Zauberer</color> zu ignorieren
ModUi/&EnableCtrlClickBypassAttackReactionPanel	Aktivieren Sie <color=cyan>STRG</color>, klicken Sie auf Angriffe, um alle Reaktionsfelder zu ignorieren
ModUi/&EnableIgnoreCtrlClickOnCriticalHit	<i>+ nur umgehen, wenn kein kritischer Treffer vorliegt</i>
ModUi/&EnableCtrlClickOnlySwapsMainHand	Aktivieren Sie den <color=cyan>CTRL</color>-Klick, um Gegenstände beim Wechseln von getragenen Konfigurationen fernzuhalten
ModUi/&MulticlassKeyHelp	<color=cyan>SHIFT</color>-Klick auf einen Zauberspruch verbraucht einen Zauberplatz anstelle des standardmäßigen Paktmagieplatzes