ModUi/&AddHelpActionToAllRaces	Adicione a ação <color=orange>Ajuda</color> a todas as corridas
ModUi/&DisableSenseDarkVisionFromAllRaces	Desative <color=orange>Sensor de Visão no Escuro</color> de todas as raças <b><i><color=red>[Requer reinicialização]</color></i></b>
ModUi/&DisableSenseSuperiorDarkVisionFromAllRaces	Desative <color=orange>Superior Sense Dark Vision</color> de todas as raças <b><i><color=red>[Requer Restart]</color></i></b>
ModUi/&EnableAlternateHuman	Ative o humano alternativo <i><color=yellow>[+1 talento / +2 escolhas de atributo / +1 habilidade]</color></i>
ModUi/&EnableFlexibleBackgrounds	Ative planos de fundo flexíveis <i><color=yellow>[selecione habilidades e habilidades de ferramentas de planos de fundo]</color></i>
ModUi/&EnableFlexibleRaces	Habilite raças flexíveis <i><color=yellow>[atribua pontos de pontuação de habilidade em vez dos padrões raciais]</color></i>
ModUi/&EnableEpicPointsAndArray	Ative um sistema épico de compra de 35 pontos e uma matriz <i><color=yellow>[17,15,13,12,10,8]</color></i> <b><i><color=red>[ Requer reinicialização]</color></i></b>
ModUi/&TotalFeatsGrantedFistLevel	<color=white>Total de talentos concedidos no primeiro nível</color>
ModUi/&EnableMinInOutAttributes	Aplicar pontuações de habilidade mínimas de pré-requisitos de entrada e saída
ModUi/&EnableRelearnSpells	Pode selecionar truques ou feitiços já aprendidos de outras classes
ModUi/&DisplayAllKnownSpellsDuringLevelUp	Exiba todos os feitiços conhecidos de outras classes durante o aumento de nível
ModUi/&MaxAllowedClasses	<color=white>Máximo de aulas permitidas</color> <b><i><color=red>[Requer reinicialização]</color></i></b>
ModUi/&EnablesAsiAndFeat	Ative o aumento de pontuação de atributo e a seleção de talentos <i><color=yellow>[em vez de uma escolha exclusiva]</color></i>
ModUi/&EnableFeatsAtEvenLevels	Habilite a seleção de talentos nos níveis de classe 2, 6, 10 e 14
ModUi/&MaxAllowedLevels	<color=white>Níveis máximos permitidos</color> <b><i><color=red>[Requer reinicialização]</color></i></b>
ModUi/&AllowUnmarkedSorcerers	Permitir <color=orange>Feiticeiros</color> desmarcados
ModUi/&OfferAdditionalLoreFriendlyNames	Ofereça nomes amigáveis ​​de lore adicionais na criação de personagens
ModUi/&UnlockAllNpcFaces	Desbloqueie todos os rostos de NPCs
ModUi/&UnlockMarkAndTatoosForAllCharacters	Desbloqueie marcações e tatuagens para todos os personagens
ModUi/&UnlockEyeStyles	Desbloqueie estilos de olhos
ModUi/&UnlockGlowingEyeColors	Desbloqueie cores de olhos brilhantes
ModUi/&UnlockGlowingColorsForAllMarksAndTatoos	Desbloqueie cores brilhantes para todas as marcações e tatuagens
ModUi/&UseOfficialAdvantageDisadvantageRules	Use regras oficiais de vantagem/desvantagem
ModUi/&AddBleedingToLesserRestoration	Adicione a condição <color=orange>Sangramento</color> às condições removidas pela <color=orange>Restauração Maior e Menor</color>
ModUi/&BlindedConditionDontAllowAttackOfOpportunity	A condição <color=orange>Cego</color> não permite ataque de oportunidade
ModUi/&AllowTargetingSelectionWhenCastingChainLightningSpell	Permitir a seleção de alvos ao lançar o feitiço <color=orange>Chain Lightning</color>
ModUi/&BestowCurseNoConcentrationRequiredForSlotLevel5OrAbove	<color=orange>Conceder Maldição</color> não requer concentração quando lançado com espaço de feitiço L5+
ModUi/&EnableUpcastConjureElementalAndFey	Ativar upcast de <color=orange>Conjure Elemental</color>, <color=orange>Conjure Fey</color>
ModUi/&OnlyShowMostPowerfulUpcastConjuredElementalOrFey	<i>+ Mostrar apenas as criaturas mais poderosas da lista de conjuração</i>
ModUi/&FixSorcererTwinnedLogic	Corrigimos o uso de metamágica dupla de <color=orange>Feiticeiro</color> <i><color=yellow>[um feitiço deve ser incapaz de atingir mais de uma criatura no nível atual do feitiço]</color></i>
ModUi/&FullyControlConjurations	Controle totalmente as conjurações <i><color=yellow>[animais, elementais, etc]</color></i>
ModUi/&AllowAnyClassToWearSylvanArmor	Permitir que qualquer classe use armadura silvestre
ModUi/&AllowDruidToWearMetalArmor	Permitir que <color=orange>Druida</color> use armadura de metal
ModUi/&DisableAutoEquip	Desativar a autoequipação de itens no inventário
ModUi/&MakeAllMagicStaveArcaneFoci	Faça todas as pautas mágicas focos arcanos <i><color=yellow>[exceto <color=orange>Cajado da Cura</color> que é Universal]</color></i> <b><i><color= red>[Requer reinicialização]</color></i></b>
ModUi/&IncreaseSenseNormalVision	Aumente o alcance de <color=orange>Sense Normal Vision</color> para habilitar ataques de longo alcance <b><i><color=red>[Requires Restart]</color></i></b>
ModUi/&QuickCastLightCantripOnWornItemsFirst	O truque de luz de lançamento rápido usa itens usados ​​​​na cabeça ou no torso primeiro
ModUi/&AddPickpocketableLoot	Adicionar espólio de carteirista <i><color=yellow>[sugerido se o recurso <color=orange>Pocket</color> estiver ativado]</color></i>
ModUi/&AllowStackedMaterialComponent	Permitir componente de material empilhado <i><color=yellow>[ex. 2x500gp diamante é equivalente a 1000gp diamante]</color></i>
ModUi/&ScaleMerchantPricesCorrectly	Dimensione os preços do comerciante corretamente/exatamente
ModUi/&InitialChoices	<color=yellow>Escolhas iniciais:</color>
ModUi/&Multiclass	<color=yellow>Multiclasse:</color>
ModUi/&Progression	<color=yellow>Progressão:</color>
ModUi/&Visuals	<color=yellow>Visual:</color>
ModUi/&House	<color=yellow>Casa:</color>
ModUi/&SRD	<color=yellow>SRD:</color>
ModUi/&General	<color=yellow>Geral:</color>
ModUi/&SelectAll	Selecionar tudo
ModUi/&SelectSuggested	Selecionar sugerido
ModUi/&ExpandAll	Expandir todos
ModUi/&ShowDescriptions	Mostrar descrições
ModUi/&Races	<color=yellow>Corridas</color>
ModUi/&Classes	<color=yellow>Aulas</color>
ModUi/&Subclasses	<color=yellow>Subclasses</color>
ModUi/&Feats	<color=yellow>Featilidades</color>
ModUi/&FightingStyles	<color=yellow>Estilos de luta</color>
ModUi/&SpellInstructions	. Você pode atribuir individualmente cada feitiço a qualquer lista de feitiços ou simplesmente selecionar o conjunto sugerido
ModUi/&SpellLevelFilter	<b><i><color=white>filtro de nível de feitiço</color> <color=yellow>[-1 para exibir todos os feitiços]</color></i></b>
ModUi/&EnableUnityExplorer	Ativar a interface do usuário do Unity Explorer
ModUi/&Patches	<color=yellow>Remendos:</color>
ModUi/&Basic	<color=yellow>Básico:</color>
ModUi/&Advanced	<color=yellow>Avançado:</color>
ModUI/&EnableBetaContent	Ative o conteúdo beta <i><color=yellow>[lembre-se de que seus heróis ou salvamentos podem ser interrompidos em atualizações futuras]</color></i> <b><i><color=red>[Requer reinicialização]</ cor></i></b>
